XXXXXXXXXXXXXXXXXXXXXXXXXXXXXXXXXXXXXXXXX
XS   X   X   X         X           X    X
X X X X X X XXXXXXX X XXXXXXXXXXX X XXX X
X X   X   X     X   X       X   X X X   X
X XXXXXXXXX XXX X XXXXXXXXX X XXX X X XXX
X     X     X X X X       X X   X X X X X
XXXXX XXXXXXX X X X XXXXX X X X X X X X X
X   X       X X X X X     X   X X X X X X
X XXXXXXXXX X X X X X XXXXXXX X X X X X X
X           X X X X X       X X   X X   X
XXXXXXXXXXX X X X X XXXXXXX X XXXXX XXXXX
X   X     X X X X X       X X X     X   X
X X X XXX X X X X XXXXXXX XXX X XXXXX XXX
X X X   X X   X   X       X         X   X
X X XXX X X X XXXXXXXXXXX X XXXXXXXXXXX X
X X   X X   X       X X   X     X       X
X XXX X XXXXXXXXXXX X X XXX XXX X X X XXX
X X   X X   X     X X X X   X X X X X   X
X X XXX X X X XXX X X X X XXX X X XXXXX X
X X   X   X   X   X   X   X     X   X   X
X XXX XXXXXXXXXXXXXXX XXXXX X XXXXX X XXX
X   X         X   X X       X       X   X
XXX XXXXXXX X X X X XXX XXXXXXXXXXXXXXX X
X   X X     X   X       X   X   X       X
XXXXX X XXXXX XXXXXXXXXXXXX X XXX XXXXX X
X       X   X X   X       X X   X X     X
X XXXXXXX X X X X X XXXXX X XXX X XXXXX X
X X       X X X X   X   X X   X X     X X
X X XXX XXX XXX X XXX XXX XXX X XXXXX X X
X X   X   X     X   X   X X X X X     X X
X XXX XXX XXXXXXXXX X X X X X X X XXXXXXX
X X   X   X X   X   X X   X     X   X   X
X X XXXXXXX X X XXX X XXXXXXX XXXXX X X X
X X     X     X     X X     X     X   X X
X XXXXX X X XXXXXXXXX XXXXX XXXXX XXXXX X
X     X X X X       X       X X   X     X
XXXXX X X X X X XXXXXXX XXXXX X XXX XXXXX
X     X X X X X X       X     X X X     X
X XXXXX X X XXX X X XXXXX XXXXX X XXXXX X
X       X X     X X       X            GX
XXXXXXXXXXXXXXXXXXXXXXXXXXXXXXXXXXXXXXXXX